9,6
#########
###  ####
#     O #
# #  #O #
# X X#A #
#########
